#########B#####
#     #   #   #
# ### # # # ###
# #       #   #
# # ##### ### #
#A# #     #   #