##B##############################################
##    ###########################################
####    #########################################
#### ## #########################################
     ##  ########################################
#######    ######################################
##    # ###################    ##################
####  # #  ######################################
#### ## #########################################
     ##  ########################################
####      ################ ######################
##    ###########################################
####             ################################
#### ## # #######################################
     ##  ##  ####################################
#A ######   #####################################
